11111111111111111111111111111111111111811111111111111111111111111111111111111111
13000700020500000000000000000000000000800000000000000000000000000000000000000001
13111111111111111111111111111111111111111111111111111111111111111111111111113001
13000000000000000000000004444444444444444444444444444444440000000000000000003001
13000300000000000000000000000000000000070000000000000000000000000000000000003001
11111311111111111111111111000000000000111000000000000000011111111111111111111111
10000300000000000000000000000000000000000000000000000000000000000000000000707071
10000311111111111111111111111111111111111111111111111111111111111111111111111111
10000300000000000000000000000000000000000000000000000000000000000000000000000001
13000300000000044444444444444444444400000000000300020202720200000000003000000001
13111111111111110000000000000000000111111111111311111111111111111111113000000001
13000000000000000000000000000000000000000000000300000000000000000000003000000001
13000000000000000000300000000002527202000000000300000000000000000000003000000001
13000000000000000000311111111111111111111111111300000000003000000000003000000001
13000000005000000000300000000000000000000000000300000000003111111111111111111111
11111111111111111111300070003000000000000000000300000000003000444444444444400001
10000000000000000000311111113000000000000000000300000000003000030000000000307031
10000000000000000000300000003000000000000000000300000000001111130000000000111131
10000060000000700000300000003000000000000000000300000000000000030000000000000031
11111111111111111111111111111111111111111111111111111111111111111111111111111111