11111111111111111111111111111111111111111111111111111111111111111111111111118111
17000003000000000000000007030700000000000000000000000000302005000200000000008001
11111113000000000000000001131100000000000000000000000000311111111111111111118001
10000003000000000000000000030000000000000000000000000000300000000000000000008001
10000003000000000000000000030000000000000000000000000000300000000000700000008001
10000001111111111111111111111111111111111111111111111111111111111111111113008001
10000000000044444444444444444444444444444444444444444444444444444440000003008001
17003000000000000000000070000000000000000000000000000000000000000000000003008001
11113111111111111100001111110000000000000000000011111111111111111111111113008001
17003000000000000000000000000000000000000000000000000000000000000000000003008001
11113000000000000000000000000000000000000000000000000000000000000000000003008001
10003000300000000000000000000500000077000005000000000000000000000000000003008001
10001111300000000000000000001111000111100011110000000000000000000000300003008001
10000000300000000000000000000000000000000000000000000000000000000000311111008001
10070000300000000000030000000000000000000000000003000000000000000000300000008001
11111111111111111111131111111111111111111111111113000000000000000000300000008001
10000000000000000000030000000000005005000000000003000000000000000000300000008001
10000000000000000000031111111111111111111111111113000000000000000000300000008001
10000060000000000000030000000000000000000000000003000000000000000000300000008701
11111111111111111111111111111111111111111111111111111111111111111111111111111111