11111111111111111111111111111111111111111111111111111111111111111111111111111111
10800000000000000000000000000000000000000000000000000000000000000000000033000001
11111111111111111222222222222111122222111122222222222222221111111111111133000001
10000000000000000000000000000000000000000000000000000000000000000000000033000001
10000000000000000000000000000000000044444444444444444444444444444444444433000001
10000000000000000000000060000007070000330000000000000000000000000000000033000001
13022220000222222222222222222222222222330000000000000000000000000000000033000001
13000000000000000000000000000000000000330000000000000000000000000000000033000001
13000000000000000000000000000000000000330000000000000000000000000000000033000001
13000004444444444444444444444444000000334444444444444444444444444444444433000001
13000000000000000070000000000000000000330000000000000000003300000070000033000001
12222222200000002222200000022222222222330000000000000000003322222222222222222221
10000000000000000000000000000000000000330000000000000000003300000000000000000001
10000000000000000000000000000000000000330000000000000000003300000000000000000001
10000000000000000000000000000000000000330000000000000000003300000000000000000001
10000000000000000070000000500000000000330000000000000000003300007000000000000001
10000000000022222222222222222222222222222220000000000000003222222222222000070001
10000000000000000000000000000000000000000000000000000000003300000000000222222221
10000700000050000000000000000000000000000000000000000000003300000000000000000001
11111111111111111111111111111111111111111111111111111111111111111111111111111111