11111111111111111111111111111111111111111111111111111111111111111111111111111111
10000000000000000000000000000000000000000000000000000000000000000000000033000001
11111111111111111222222222222111111111111111111111111111111111111111111133000001
10000000000000000000000000000000000000000000000000000000000000000000000033000001
10000000000000000000000000000000000000000000000000000000000000000000000033000001
10000000000000000000000000000000000000000000000000000000000000000000000033000001
10000000000111111111112222222111111111330000000000000000000000000000000033000001
10000000000000000000000000000000000000330000000000000000000000000000000033000001
10000000000000000000000000000000000000330000000000000000000000000000000033000001
10000000000000000000000000000000000000330000000000000000000000000000000033000001
10000000000000000000000000000000000000330000000000000000000000000000000033000001
10000000000000000000000000000000000000330000000000000000003322222222222222222221
10000000000000000000000000000000000000330000000000000000003300000000000000000001
10000000000000000000000000000000000000330000000000000000003300000000000000000001
10000000000000000000000000000000000000330000000000000000003300000000000000000001
10000000000000000000000000000000000000330000000000000000003300000000000000000001
10000000000011111111111111111111111111111110000000000000003300000000000000000001
10000000000000000000000000000000000000000000000000000000003300000000000000000001
10000000000000000000000000000000000000000000000000000000003300000000000000000001
11111111111111111111111111111111111111111111111111111111111111111111111111111111